name test dungeon
win 2
##########
#..GGGE..#
#..GG.E..#
#.....E..#
##########